1111111111111
10010000000C1
10000111000C1
10E0110O000P1
1111111111111
