1111111111111
10010000000C1
10CCP111000C1
10EP11EO000P1
1111111111111
