1111111111111
10010000000C1
10000111110C1
1P0011E0000P1
1111111111111