1111111111111
10010000000C1
100001111O001
1P0011E0000O1
1111111111111